11111111111111
10010C00000C01
10000111110011
100110000001P1
10000C00000001
11111111111111
