11111111111111
10010C00000C01
10000111110011
10011E000001P1
10000C00000E01
11111111111111
