11111111111111
1001000000EP01
10000111110001
11111111110001
10000000000001
11111111111111
