11111111111111
10010C00000C01
10000111110011
10011E00000101
10000C00000001
11111111111111
