11111111111111
1P010C00000C01
10000111110011
10011E00000101
10000C00000P01
11111111111111
