11111111111111
10010C0000EPC1
10000111110001
11111111111111
10000C00000001
11111111111111
