11111111111111
10000C1111EPC1
10100111110001
10100111110001
1C100000000001
11111111111111
